50
o.o.....o.o.......ooo.....o...o....o.......o.o..o.
......o....o.o..o...o..o..o......o.........o......
..o......ooo..o...o.o......oo.......o.....oo......
o.o.....o....o.....o.o.....o....oo................
.......o..o..oo....oo.....o..............o..o..o..
o...o.oo.........o....oo....o.oo...o.o....oo......
.o.....oo....o.o.....o............o..........ooo..
o......o..o.o...o.........o.........o..ooo......o.
o..................o....o..........o........oo..o.
.......o......o..o..o.o...o....o.........o........
.....o........o...o..oo..o.o.....o.o.....o..oo....
o......o..........o..o..o......o..oooo..oo......o.
.ooo................o..o...o...............o...o..
..ooo.....oo...o............o..oo...o.......oo...o
o..o........o...o.........o........oo...o.oo..o..o
..o....oo.........o..o....o....o....oo......o..o..
..o.o..o........o......o...o.o....o...........oo.o
..o..oo...o..oo.o..o.........o.o......o...........
.....oo...o.oo..o.......o.oo...o...o........o..o..
.oooo.....o..........................oo.o....oo.o.
.o..o.o....oo.oo..........o...oo..o....o..........
.o....o.....o...o...o...o.......o......o.......o..
.....o.......o.....o..oo.............o...oo.......
..oo..o.....o..o...oo.....o..o...o.o..oo.....oo...
...oo..o...........o...o..o.....o..........o......
.....o.oo............o.o.oo.....o.......o..oo....o
.......o.....o...o.....o.oo..o.......o.....ooo.o..
.....o..oo..o..o.....o......o........o....o....o..
...o....o.o..............o....o.o............o....
o.....o.oo.o.o..oo....o..........o......o.........
o....o.........o................o.o...o.ooo..o....
....o..o.............o...o....o.o...o..ooo..o.o.o.
.....o...........o......oo........o..o...oo..o....
...o.....o...o..o...........o....o.........o.oo...
.....o...o....oo....oooo....o.o.....oo..o.o.....oo
......o....oo..oo..................o.o.....o....o.
o...o.o.................o.o..o.o.o..o.......o.....
.....oo.oo.o.......o.....o........o.o........o...o
o......oo.oo...o........................oo......o.
....o....ooo.o..o.........ooooo...................
..oo..o.o...oo......o.o...o.o.o..oo...oo...o..o...
..............o.o.........o.o.........o.....o.....
.o..o.....o.o.o........o..o...o..........o..oo....
o...o....o......o...o..oo..o.o...o.o....o..o.oo...
......oo..o.....o........o.........ooo.....o.....o
.....o......o............o..o......o........o.....
.........o......o.o........o.....oo......o........
....................oo....o.o..o....o..o..oooo....
.o....o.o.o......o.oo......o.oo.o..o..o....o......
...ooo........o.o..oo.ooo.o.....o......o..o...o...
